NO ./texs/wall1.xpm
SO ./texs/wall2.xpm
WE ./texs/wall3.xpm
EA ./texs/wall4.xpm

F 00,10,15
C 100,90,200

        1111111111111111111111111
        1000000001100000000000011
        1011000001111000000S00001
        1001000000000000000000111
111111111011113111100000000000011
10000000001100000111311111111111
11110111111111011100000010001
11110111111111011101010010011
11000000110101011100000010001
11110000000000003200000010011
10011000000000001101010010001
11000001110101011111000000111
11110111 1110101 101111010001
11111111 1111111 111111111111